SUBMODULE	CHANNEL NAME	TAGS
r_gifs 	@r_gifs	#gif #fun
r_jokes 	@r_jokes	#fun #text
r_funny 	@r_funny	#fun
datascientology 	@datascientology	#datascience #maps #data #infographics
asiangirlsbeingcute 	@asiangirlsbeingcute	#fun #gif
r_behindthegifs 	@r_behindthegifs	#gif #comics
pythondaily 	@pythondaily	#python #programming
r_unexpected 	@r_unexpected	#fun
history 	@RedditHistory	#history #photos
r_bitcoin 	@r_bitcoin	#crypto #bitcoin
news 	@news756	#news
r_pics 	@r_pics_redux	#pic
cats 	@RedditCats	#cats #pic #gif
r_til 	@r_til	#learning
awwnime 	@awwnime	#anime
r_mlp 	@r_mlp	
ya_metro 	@ya_metro	#publictransport #metro #tram #subway #underground
r_showerthoughts 	@r_Showerthoughts	#deep
r_me_irl 	@r_me_irl	#memes
r_dankmemes 	@r_dankmemes	#memes
r_highqualitygifs 	@r_HighQualityGifs	#gif
politicalhumor 	@PoliticalHumor	#fun
food 	@reddit_food	#sfw #porn
oldschoolcool 	@OldSchoolCool	
rddit 	@rddit	#reddit #gif
denpasong 	@denpasong	
r_movies 	@r_movies	
reddit_all 	@reddit_all	#global
r_gentlemanboners 	@r_gentlemanboners	
r_askreddit 	@r_AskReddit	#reddit
r_explainmelikeimfive 	@r_explainmelikeimfive	#learning
r_changemyview 	@r_changemyview	
just_hmmm 	@just_hmmm	#hmmm
programmer_humor 	@programmer_humor	#programming
dailyfoodporn 	@dailyfoodporn	#sfw #porn
r_overwatch 	@r_overwatch	#gaming
r_cryptocurrency 	@r_cryptocurrency	#crypto
r_listentothis 	@r_listentothis	
r_pantsu 	@r_pantsu	
r_ramen 	@r_ramen	#ramen
freefolk 	@r_freefolk	
r_fantheories 	@r_fantheories	
r_slimerancher 	@r_SlimeRancher	#gaming
r_googleplaydeals 	@r_googleplaydeals	#android
r_tinder 	@rtinder	
indiancelebs 	@Indiancelebs	
r_pcmasterrace 	@r_pcmasterrace	#gaming
r_rupaulsdragrace 	@r_rupaulsdragrace	
gifffs 	@GIFFFs	#gif
r_wow 	@r_wow	#gaming
r_minecraft 	@r_minecraft	#gaming
maybemaybemaybe 	@MaybeMaybeMaybe	
r_wholesomememes 	@r_wholesomememes	
r_arthelpreddit 	@arthelpreddit	#art
r_streetwear 	@r_streetwear	#fashion
r_bettereveryloop 	@BetterEveryLoop	#gif
r_fashion 	@reddit_fashion	#fashion
r_opensignups 	@r_opensignups	
r_biganimetiddies 	@r_BigAnimeTiddies	#porn
r_damnthatsinteresting 	@r_Damnthatsinteresting	
fakealbumcovers 	@fakealbumcovers	#music #albums #fake
dash_cams 	@dash_cams	
r_mild 	@r_mild	
happiness 	@get_happiness	
r_porn 	@r_porn	#porn #sfw #porn
r_f1 	@r_formula1	
r_cpp 	@r_cpp	#programming
r_gaming 	@r_gaming	#gaming
r_dontdeadopeninside 	@r_dontdeadopeninside	
r_linux 	@r_linux	
android 	@reddit_android	#android
r_techsupportgore 	@r_TechSupportGore	
r_indiaa 	@r_indiaa	
r_dndgreentext 	@r_dndgreentext	#rpg #memes #reading #dnd #fun #pic #photos
r_dndmemes 	@r_dndmemes	#rpg #memes #pic #dnd #fun
r_chemicalreactionsgifs 	@r_chemicalreactiongifs	
r_wheredidthesodago 	@r_wheredidthesodago	#outofcontext
r_switchhacks 	@r_SwitchHacks	
r_books 	@r_books	#book
r_suggest 	@r_suggest	#book
r_space 	@r_space	
wasletztepreis 	@r_wasletztepreis	
greentext 	@r_greentext	
r_crappyoffbrands 	@r_crappyoffbrands	
r_chemistry 	@r_chemistry	
r_vim 	@r_vim	#programming
r_talesfromtechsupport 	@r_talesfromtechsupport	
r_pewdiepiesubmissions 	@r_PewdiepieSubmissions	
r_dankchristianmemes 	@r_dankchristianmemes	#memes
r_disneyvacation 	@r_disneyvacation	#outofcontext
r_punny 	@R_Punny	
r_mapporn 	@r_mapporn	#sfw #porn
r_softwaregore 	@r_softwaregore	
r_crappydesign 	@r_crappydesign	
reddit_xiaomi 	@reddit_xiaomi	#android
comics 	@r_comics	#comics
amd 	@RAyyMD	
r_remotejs 	@r_remotejs	
streetmoe 	@streetmoe	
r_foxes 	@r_foxes	
r_digimon 	@r_digimon	
r_furry 	@r_furry	
r_ik_ihe 	@r_ik_ihe	#dutch #memes
r_mildlyinfuriating 	@r_mildlyinfuriating	
r_animemes 	@r_Animemes	#anime #memes
r_wellthatsucks 	@r_wellthatsucks	
rtf2memes 	@rtf2memes	
arma 	@r_arma	
r_grandorder 	@r_grandorder	
r_2meirl4meirl 	@r_2meirl4meirl	
r_photoshopbattles 	@r_photoshopbattles	
r_pornhubcomments 	@r_pornhubcomments	#porn
r_anime_irl 	@r_animeirl	
indepthstories 	@indepthstories	
r_osugame 	@r_osugame	
r_freegamesonsteam 	@r_FreeGamesOnSteam	#gaming
reddit_cartoons 	@reddit_cartoons	
rcosplaygirls 	@rcosplaygirls	
r_technope 	@r_technope	
rcarporn 	@rcarporn	#sfw #porn
r_desktops 	@r_desktops	
r_nocontextpics 	@r_nocontextpics	
r_vinyl 	@r_vinyl	#music
r_creepy 	@r_creepy	
deepfriedmemes 	@deepfriedmemeschannel	
r_hentaimemes 	@r_HentaiMemes	
r_longtext 	@r_longtext	#text #longtext
rareinsults 	@rareinsults	
r_sbubby 	@r_sbubby	
loliconsunite 	@loliconsunite	
r_privacy 	@r_privacy	#privacy
r_wikileaks 	@r_WikiLeaks	
reddit_androiddev 	@reddit_androiddev	#android #programming
proceduralgeneration 	@proceduralgeneration	
r_gtaonline 	@r_gtaonline	#gaming
ichimechtenleben 	@ichimechtenleben	
ingressprimefeedback 	@IngressPrimeFeedback	
soccer_reddit 	@soccer_reddit	#sport
r_reddevils 	@r_reddevils	
nfl_reddit 	@NFL_reddit	#sport
r_texans 	@r_texans	
r_xxxtentacion 	@r_xxxtentacion	
r_quotesporn 	@r_quotesporn	#porn
r_getmotivated 	@r_getmotivated	
rhqdesi 	@rhqdesi	
r_podcasts 	@r_Podcasts	
r_imaginary_network 	@r_imaginary_network	
r_maxestla 	@r_MaxEstLa	#french
r_selfhosted 	@r_SelfHosted	
r_internetisbeautiful 	@r_InternetIsBeautiful	
r_thinkpadsforsale 	@r_thinkpadsforsale	
redditvideos 	@redditvideos	
rsoccerbetting 	@rsoccerbetting	
r_xboxone 	@r_xboxone	#gaming
livestreamfail 	@LivestreamFail	
facepalmers 	@facepalmers	
completeanarchy_tg 	@completeanarchy_tg	
im14andthisisdeep 	@wokesouls	
r_comedycemetery 	@r_ComedyCemetery	
r_latestagecapitalism 	@r_latestagecapitalism	
shitliberalssay 	@ShitLiberalsSay	
redditpiracy 	@redditpiracy	#piracy
r_chapotraphouse 	@r_ChapoTrapHouse	
r_contrapoints 	@r_ContraPoints	
r_me_ira 	@r_me_ira	
ingress 	@IngressReddit	
youtubecompendium 	@YoutubeCompendium	
r_oddlysatisfying 	@oddly_satisfy	
jenkins 	@r_jenkins	#programming
jenkinsci 	@jenkinsci	#programming
redditart 	@redditart	#art
r_interestingasfuck 	@r_interestingasfuck	
r_programming 	@r_Pr0gramming	#programming
r_rimworld 	@r_RimWorld	#gaming
r_woooosh 	@r_woooosh	
instant_regret 	@instant_regret	
r_djs 	@r_djs	
r_marvelstudios 	@r_marvelstudios	
r_igthft 	@r_ImToGoingHellForThis	
celebrityarmpits 	@CelebrityArmpits	
r_creepyasterisks 	@r_creepyasterisks	
alltwitter 	@AllTwitter	#twitter
r_tihi 	@r_TIHI	#thanksihateit #tihi #wtf #ihateit
r_therewasanattempt 	@r_therewasanattempt	#memes #gif #fun
r_wpdi 	@r_WatchPeopleDieInside	#memes #gif #fun
r_youtubehaiku 	@r_youtubehaiku	
sub_eminem 	@sub_eminem	
r_jailbreak 	@r_jailbreak	#ios
reddit2telegram	@reddit2telegram	#reddit #telegram #meta
r_shittyramen 	@r_shittyramen	#ramen #pic
bestoftweets 	@bestoftweets	#twitter
blackpeopletweets 	@blackpeopletweets	#twitter
whitepeopletweets 	@whitepeopletweets	#twitter
r_trackers 	@r_trackers	#torrents
r_vault_hunters 	@r_vault_hunters	
therightcantmeme 	@therightcantmeme	